1111111111111111111111111111111111
100000000000001C10000C000000000001
10100101000E0001101001000000010101
1010010010101010001001000000010101
10000001PC00C0000000000000000000C1
1111111111111111111111111111111111
