111111111
100100001
1CC001011
101C00C01
1010P1001
10011CC01
1C00000E1
1C0000CC1
10C0000C1
111111111
